1111111111111111111111111111111111
1E1000000000000C00000C000000000001
1100101001000001010010000000101011
1010010010101010001001000000010101
1010010010101010001001000000010101
1010010010101010001001000000010101
1010010010101010001001000000010101
1010010010101010001001000000010101
1010010010101010001001000000010101
1010010010101010001001000000010101
1010010010101010001001000000010101
1010010010101010001001000000010101
1010010010101010001001000000010101
1010010010101010001001000000010101
1010010010101010001001000000010101
1010010010101010001001000000010101
1010010010101010001001000000010101
1010010010101010001001000000010101
1P1000000C00C0000000000000000000C1
1111111111111111111111111111111111
3289479237492
498592795927922
325896235932992792
325923895692395
lrjegherlrejlfk
w;g
glreglkjwe'wg
wjgremg[wg








