1111111111111
10010000000C1
1X00011111001
1P0011E000001
1111X11111111
1111111111111