1111111111111
10X10000000C1
10X0011111X01
1P0011XE00001
1111111111111